###############
#     @x       #
#             #
#             #
#             #
#             #
#             #
#             #
#             #
#             #
#             #
#             #
#             #
#             #
###############
